XXXXXXXXXXXXXXXXXXXXXXXXXXXXXXXXXXXXXXXXXXXXXXXXXXXXXXXXXXXXXXXXXXXXXXXXXXXXXXXX
X                                                                              X
X                                                                              X
X                                                                              X
X                                                                              X
X                                                                              X
X                                                                              X
X                                                                              X
X                                                                              X
X                                                                              X
X                                                                              X
X                                                                              X
X                                         o                                    X
X                                                                              X
X                                                                              X
X                                                                              X
x                                                                              X
X                                                                              X
X                                                                              X
X                                                                              X
X                                                                              X
X                                                                              X
X                                                                              X
X                                                                              X
X                                                                              X
X                                                                              X
X                                                                              X
X                                                                              X
X                                                                              X
XXXXXXXXXXXXXXXXXXXXXXXXXXXXXXXXXXXXXXXXXXXXXXXXXXXXXXXXXXXXXXXXXXXXXXXXXXXXXXXX